##      #B   #######
## ###### ##       #
## ###### #### ### #
##      # ##    #  #
####### # ##### # ##
#       #   ### # ##
# #### #### ### # ##
#   ## #    ##  # ##
# # ##   ####  ## ##
# #  ### # ## ###  #
# ######      ######
#   ############## #
###          #   # #
#   ## ### ### # # #
# #  # ##    # # # #
# ## # ## ## # # # #
#### #  #  # # # # #
#    ## ####   # # #
# ### #   ######   #
#     ###    A######