#################
#               #
#               #
#               #
#        A      #
#               #
#               #
#               #
#               #
#               #
#               #
#   ##########  #
#               #
#               #
#               #
#               #
#         B     #
#################